OOOOOOOOOOOOOOOOOOOOOOOO
O O . O    O       O   O
O O O O  O O OOOOO.OOO O
O   O OOOO O O         O
O.O O .    O O OOOOOO OO
O O O OOOOOO O    O    O
O OOO        OOOO.OO O O
O   OOOOOOOOOO O   O O O
OOO .      O O O OOO O O
O O OOOOOO.O O O O O O O
O O O    O O . O O OOOOO
O O.OOOO O O OOO O     U
O.O .    O O   O O.OOOOO
O O OOOOOO OOO O O O O O
O   O    O   O O O   O O
O O O OO O.OOO O OOO O O
O O O O  O   O . O O . O
O.O O OOOOOO O OOO OOO O
O   O .      O         O
OOOOOOOOOOOOOOOOOOOOOOOO
